//MAP CONVERTED BY dmm2tgm.py THIS HEADER COMMENT PREVENTS RECONVERSION, DO NOT REMOVE
"a" = (
/turf/closed/wall,
/area/space)
"b" = (
/obj/machinery/light/wall,
/turf/open/floor/plating/elevatorshaft,
/area/space)
"c" = (
/turf/open/floor/plating/elevatorshaft,
/area/space)

(1,1,1) = {"
a
a
a
a
"}
(2,1,1) = {"
a
b
c
c
"}
(3,1,1) = {"
a
c
c
c
"}
(4,1,1) = {"
a
b
c
c
"}
(5,1,1) = {"
a
a
a
a
"}
